NO ./textures/north.xpm
F 34,139,34
SO ./textures/south.xpm
WE ./textures/west.xpm
EA ./textures/east.xpm
C 135,206,250

       1
      101 
    111011
11111000000001
1000000001
11111100N1
    111011
      101
       1

