NO ./textures/north.xpm
SO ./textures/south.xpm
WE ./textures/west.xpm
EA ./textures/east.xpm
F 34,139,34
C 135,206,250

1111111
1000001
1000001
1000N01
1111111
