NO ./textures/north.xpm
F 220,100,0
SO ./textures/south.xpm
WE ./textures/west.xpm
EA ./textures/east.xpm
C 225,30,0

111111
100X01
101001
1100N1
111111
