NO ./textures/north.xpm
SO ./textures/south.xpm
WE ./textures/west.xpm
EA ./textures/east.xpm
F 220,111,119
C 225,111,200


                1111111 
                100S001
     11         1100011
                 11011
                  111
