NO ./textures/north.xpm
SO ./textures/south.xpm
WE ./textures/west.xpm
EA ./textures/east.xpm
F 220,111,119
C 225,111,200



 111111111111111111111111
 100000000000S00000000001
 110000000000000000000011
  1100000000000000000011
   11000000000000000011
    110000000000000011
     1100000000000011
      11000000000011
       110000000011
        1100000011
         11000011
          110011
           1111