111111
100101
101001
1100N1
111111

NO ./textures/north.xpm
F 34,139,34
SO ./textures/south.xpm
WE ./textures/west.xpm
EA ./textures/east.xpm
C 135,206,250
    