11111
1P0E0
1C001
10001
11111
