11111
1P0E1
11111
1C001
11111
