11111111111111111111
1P0000000000000000C1
11111111111111111101
1E000000000000000001
11111111111111111111
