111111
1000P1
1P0001
1E0001
111111