1111111111111111111111111
1P00000000000000000000001
1011111110111111111111101
1000000010000000000000101
1111101010111111110111101
1000101010000000010100001
1010101011111101010111111
1010101000000101010000001
1010111011110101011111101
1000000010000101000000101
1111111010111101111110101
1000001000100001000000101
1011101010111111011111101
1010001010000001000000001
1010111011111111011111011
1010001000000001001000001
1111101111111111010111101
1000000000000000010000E01
1011111111111111011111101
1000000000000000010000001
1011111111111111010111001
1000000000000000010000001
1111111111111111010111101
1C00000000000000000000001
1111111111111111111111111
