1111111111111111111111111111111111111111111111111111
1P00000000000000000000000000000000000000000000000001
1011111111111111111111111111111111111111111111101011
1000000000000000000000000000000000000000000000000101
1111101111111111111111111111111111111111111111101011
1000101010000000000000000000000000000000101000000101
1010101010111111111111101111111111110101011110101011
1010101010100000000000001010101000000000000101000101
1010111011111111111111111010101011111111111010101011
1000000000000000000000000000000000000000000000000101
1111111011111111111111111111111111111111111111101011
1000000000000000010000101000000000000000000000100001
1011101010111111111101111111111010101111111101000101
1010001010000001000000000000000000000001000100001001
1010111011111111011111101111111111010101011110110101
1010001000000001000000000000000000000001000000101001
1111101111111111111111111111111111011111111011110101
1000000000000000010000000000000000000000000000000101
1011111111111111111111111111111111111111111111110101
1000000000000000000000000000000000000000000000000001
1011111111111111111111111111111111111111111111100101
1000000000000000000000000000000000000000000000000001
1111111111111111111111111111011111111111111111111111
1C000000000000000000000000000000000000000000000000E1
1111111111111111111111111111111111111111111111111111