111111
100001
1P0001
1E00C1
100001
111111