111111
1000A1
1P0001
1E00C1
100001
111111