11111111111111111111111111111111111111111111111111111111111111111111
1P000000000000000000000000000000000000000000000000000000000000111111
10111111111111111111111111111111111111111111111111111111111111111111
10000000000000000000000000000000000000000000000000000000000000111111
11110111111111111111111111111111111111111111111111111111111110111111
10000100000000000000000000000000000000000000000000000000000000111111
10110111111111111111111111111111111111111111111111111111111110111111
10110100000000000000000000000000000000000000000000000000000010111111
10110101111111111111111111111111111111111111111111111111110110111111
10000000000000000000000000000000000000000000000000000000000000111111
11110111111111111111111111111111111111111111111111111111110110111111
10000100000000000000000000000000000000000000000000000000000000111111
10110111111111111111111111111111111111111111111111111111111110111111
10100000000000000000000000000000000000000000000000000000000010111111
10111110111111111111111110111111111111111111111111111111110110111111
10000100100000000000000000100000000000000000000000000100000100111111
11110111111111111111111111111111111111111111111111111111110110111111
10000000000000000000000000000000000000000000000000000000000000111111
10110111111011111111111111111111111111111111111111111111110110111111
10110100000000000000000000000000000000000000000000000000000010111111
10110111110111111111111111111111111111111111111111111111111110111111
10000001000000000000000000000000000000000000000000000000000000111111
11110111111111111111111111111111111111111111111111111111110110111111
10000100000000000000000000000000000000000000000000000000000000111111
10111111111111111111111111111111111111111111111111111111110110111111
10000000000000100000000000000000000000000000000000000000000000111111
11111111111111111111111111111111111111111111111111111111110111111111
1C000000000000000000000000000000000000000000000000000000000E00111111
11111111111111111111111111111111111111111111111111111111111111111111
