111111111111111111111111111111111111111111111111111111111111111111111111111111
1P0000000000000000000000000000000000000000000000000000000000000000000000000001
101111111111111111111111111111111111111111111111111111111111111111111111111111
100000000000000000000000000000000000000000000000000000000000000000000000000001
111101111111111111111111111111111111111111111111111111111111111111111111111111
100001000000000000000000000000000000000000000000000000000000000000000000000001
101101111111111111111111111111111111111111111111111111111111111111111111111111
101101000000000000000000000000000000000000000000000000000000000000000000000001
101101011111111111111111111111111111111111111111111111111111111111111111111111
100000000000000000000000000000000000000000000000000000000000000000000000000001
111101111111111111111111111111111111111111111111111111111111111111111111111111
100001000000000000000000000000000000000000000000000000000000000000000000000001
101101111111111111111111111111111111111111111111111111111111111111111111111111
101000000000000000000000000000000000000000000000000000000000000000000000000001
101111101111111111111111111111111111111111111111111111111111111111111111111111
100001001000000000000000001000000000000000000000000000000000000000000000000001
111101111111111111111111111111111111111111111111111111111111111111111111111111
100000000000000000000000000000000000000000000000000000000000000000000000000001
101101111110111111111111111111111111111111111111111111111111111111111111111111
101101000000000000000000000000000000000000000000000000000000000000000000000001
101101111101111111111111111111111111111111111111111111111111111111111111111111
100000010000000000000000000000000000000000000000000000000000000000000000000001
111101111111111111111111111111111111111111111111111111111111111111111111111111
100001000000000000000000000000000000000000000000000000000000000000000000000001
101111111111111111111111111111111111111111111111111111111111111111111111111111
100000000000000000000000000000000000000000000000000000000000000000000000000001
111111111111111111111110111111111111111111111111111111111111111111111111111111
1C0000000000000000000000000000000000000000000000000000000E00000000000000000001
111111111111111111111111111111111111111111111111111111111111111111111111111111
