111111111111111111111111111111111111111111111111111111111111111111111111111111111111111
1P0000000000000000000000000000000000000000000000000000000000000000000000000000000000001
101111111111111111111111111111111111111111111111111111111111111111111111111111111111101
100000000000000000000000000000000000000000000000000000000000000000000000000000000000001
111101111111111111111111111111111111111111111111111111111111111111111111111111111101101
100001000000000000000000000000000000000000000000000000000000000000000000000000000000001
101101111111111111111111111111111111111111111111111111111111111111111111111111111111101
101101000000000000000000000000000000000000000000000000000000000000000000000000000000101
101101011111111111111111111111111111111111111111111111111111111111111111111111111101101
100000000000000000000000000000000000000000000000000000000000000000000000000000000000001
111101111111111111111111111111111111111111111111111111111111111111111111111111111101101
100001000000000000000000000000000000000000000000000000000000000000000000000000000000001
101101111111111111111111111111111111111111111111111111111111111111111111111111111111101
101000000000000000000000000000000000000000000000000000000000000000000000000000000000101
101111101111111111111111111111111111111111111111111111111111111111111111111111111101101
100001001000000000000000001000000000000000000000000000000000000000000000000000000000001
111101111111111111111111111111111111111111111111111111111111111111111111111111111101101
100000000000000000000000000000000000000000000000000000000000000000000000000000000000001
101101111110111111111111111111111111111111111111111111111111111111111111111111111101101
101101000000000000000000000000000000000000000000000000000000000000000000000000000000101
101101111101111111111111111111111111111111111111111111111111111111111111111111111111101
100000010000000000000000000000000000000000000000000000000000000000000000000000000000001
111101111111111111111111111111111111111111111111111111111111111111111111111111111101101
100001000000000000000000000000000000000000000000000000000000000000000000000000000000001
101111111111111111111111111111111111111111111111111111111111111111111111111111111101101
100000000000001000000000000000000000000000000000000000000000000000000000000000000000001
111111111111111111111111111111111111111111111111111111111111111111111111111111111101111
1C000000000000000000000000000000000000000000000000000000000000000000000000000000000E001
111111111111111111111111111111111111111111111111111111111111111111111111111111111111111
