111111
1P0C01
100001
1E0001
111111